#######################
# P     #         O####
#       #  #########  #
### ######    ######X #
#      ###            #
######X  #  #######   #
#       O#####      ###
# # ######   ##  ######
# #          ## O#    #
# ######### ####X#    #
#                     #
#######################
